1111111111111111111111111111111111111111
1000000000000000000000000000000000000001
1000000000000000000100000000000000000001
1000000000000000000100000000000000000001
1000000000000000000100000000000000000001
1000000000000000000100000000000000000001
1000000000000000000000000000000000000001
1000000000000000000000000000000000000001
1000000000000000000000000000000000000001
1000000001111111100000111111110000000001
1000000001000000000000000000010000000001
1000000001000000000000000000010000000001
1000000001000000000000000000010000000001
1000000000000000001110000000000000000001
1111100000000000001110000000000000011111
1000000000000000001110000000000000000001
1000000001000000000000000000010000000001
1000000001000000000000000000010000000001
1000000001000000000000000000010000000001
1000000001111111100000111111110000000001
1000000000000000000000000000000000000001
1000000000000000000000000000000000000001
1000000000000000000000000000000000000001
1000000000000000000100000000000000000001
1000000000000000000100000000000000000001
1000000000000000000100000000000000000001
1000000000000000000100000000000000000001
1002000000000000000100000000000000000001
1000000000000000000000000000000000000001
1111111111111111111111111111111111111111