1111111111111111111111111111111111111111
1000000000011111111111111111100000000001
1000000000011111111111111111100000000001
1000000000011111111111111111100000000001
1000000000011111111111111111100000000001
1000000000011111111111111111100000000001
1000000000011111111111111111100000000001
1000000000000000000000000000000000000001
1000000000000000000000000000000000000001
1000000000000000000000000000000000000001
1000000000000000000000000000000000000001
1000000000000000000000000000000000000001
1000000000000000000000000000000000000001
1000000000000000000000000000000000000001
1000000000000000000000000000000000000001
1000000000000000000020000000000000000001
1000000000000000000000000000000000000001
1000000000000000000000000000000000000001
1000000000000000000000000000000000000001
1000000000000000000000000000000000000001
1000000000000000000000000000000000000001
1000000000000000000000000000000000000001
1000000000000000000000000000000000000001
1000000000011111111111111111100000000001
1000000000011111111111111111100000000001
1000000000011111111111111111100000000001
1000000000011111111111111111100000000001
1000000000011111111111111111100000000001
1000000000011111111111111111100000000001
1111111111111111111111111111111111111111